02,00,00,00,01,00,00,00,00,00,00,00,00,00,01,00,00,00,01,00,00,00,00,00,00,00,00,00,28
03,04,04,04,07,04,04,04,04,04,04,04,04,04,07,04,04,04,07,04,04,04,04,04,04,04,04,04,26
03,04,04,04,15,04,11,06,08,06,06,06,17,04,07,04,14,06,16,04,11,06,06,06,06,06,18,04,26
03,04,04,04,04,04,07,04,07,04,04,04,04,04,07,04,04,04,04,04,07,04,04,04,04,04,07,04,26
05,06,08,06,17,04,07,04,07,04,11,06,06,06,10,04,14,06,06,06,10,04,14,06,18,04,07,04,26
03,04,07,04,04,04,07,04,07,04,07,04,04,04,07,04,04,04,04,04,07,04,04,04,07,04,07,04,26
03,04,07,04,14,06,16,04,07,04,07,04,14,06,21,06,06,06,18,04,19,06,18,04,07,04,07,04,26
03,04,07,04,04,04,04,04,07,04,07,04,04,04,04,04,04,04,07,04,04,04,07,04,07,04,07,04,26
03,04,15,04,11,06,06,06,10,04,07,04,20,04,11,06,06,06,21,06,18,04,19,06,16,04,07,04,26
03,04,04,04,07,04,04,04,07,04,07,04,07,04,07,04,04,04,04,04,07,04,04,04,04,04,07,04,26
03,04,04,14,13,06,18,04,07,04,19,06,10,04,07,04,20,04,14,06,21,06,17,04,11,06,16,04,26
03,04,04,04,07,04,07,04,07,04,04,04,07,04,07,04,07,04,04,04,04,04,04,04,07,04,04,04,26
05,06,18,04,15,04,07,04,19,06,18,04,07,04,15,04,12,06,06,06,06,06,08,06,16,04,20,04,26
03,04,07,04,04,04,07,04,04,04,07,04,07,04,04,04,07,04,04,04,04,04,07,04,04,04,07,04,26
03,04,19,06,18,04,19,06,18,04,07,04,07,04,11,06,09,06,18,04,20,04,07,04,14,06,21,06,27
03,04,04,04,07,04,04,04,07,04,07,04,07,04,07,04,04,04,07,04,07,04,07,04,04,04,04,04,26
03,04,20,04,19,06,18,04,07,04,07,04,07,04,15,04,20,04,12,06,16,04,19,06,06,06,18,04,26
03,04,07,04,04,04,07,04,07,04,07,04,07,04,04,04,07,04,07,04,04,04,04,04,04,04,07,04,26
03,04,12,06,17,04,07,04,07,04,15,04,12,06,06,06,10,04,07,04,11,06,06,06,06,06,16,04,26
03,04,07,04,04,04,07,04,07,04,04,04,07,04,04,04,07,04,07,04,07,04,04,04,04,04,04,04,26
03,04,12,06,06,06,16,04,12,06,06,06,13,06,17,04,07,04,15,04,07,04,14,06,06,06,18,04,26
03,04,07,04,04,04,04,04,07,04,04,04,07,04,04,04,07,04,04,04,07,04,04,04,04,04,07,04,26
03,04,07,04,11,06,06,06,16,04,20,04,15,04,20,04,19,06,18,04,12,06,06,06,18,04,07,04,26
03,04,07,04,07,04,04,04,04,04,07,04,04,04,07,04,04,04,07,04,07,04,04,04,07,04,07,04,26
03,04,07,04,19,06,06,06,18,04,19,06,06,06,21,06,06,06,16,04,19,06,17,04,07,04,07,04,26
03,04,07,04,04,04,04,04,07,04,04,04,04,04,04,04,04,04,04,04,04,04,04,04,07,04,07,04,26
03,04,12,06,06,06,17,04,07,04,11,06,06,06,18,04,11,06,22,06,06,06,06,06,16,04,07,04,26
03,04,07,04,04,04,04,04,07,04,07,04,04,04,07,04,07,04,07,04,04,04,04,04,04,04,07,04,26
03,04,15,04,11,06,06,06,21,06,16,04,20,04,07,04,15,04,07,04,14,06,06,06,22,06,16,04,26
03,04,04,04,07,04,04,04,04,04,04,04,07,04,07,04,04,04,07,04,04,04,04,04,07,04,04,04,26
03,04,14,06,16,04,11,06,06,06,06,06,16,04,19,06,06,06,21,06,06,06,17,04,07,04,04,04,26
03,04,04,04,04,04,07,04,04,04,04,04,04,04,04,04,04,04,04,04,04,04,04,04,07,04,04,04,26
23,24,24,24,24,24,29,24,24,24,24,24,24,24,24,24,24,24,24,24,24,24,24,24,29,24,24,24,25

1,1,1,1,1,1,1,1,1,1,1,1,1,1,1,1,1,1,1,1,1,1,1,1,1,1,1,1,1
1,0,0,0,1,0,0,0,0,0,0,0,0,0,1,0,0,0,1,0,0,0,0,0,0,0,0,0,1
1,0,0,0,1,0,1,1,1,1,1,1,1,0,1,0,1,1,1,0,1,1,1,1,1,1,1,0,1
1,0,0,0,0,0,1,0,1,0,0,0,0,0,1,0,0,0,0,0,1,0,0,0,0,0,1,0,1
1,1,1,1,1,0,1,0,1,0,1,1,1,1,1,0,1,1,1,1,1,0,1,1,1,0,1,0,1
1,0,1,0,0,0,1,0,1,0,1,0,0,0,1,0,0,0,0,0,1,0,0,0,1,0,1,0,1
1,0,1,0,1,1,1,0,1,0,1,0,1,1,1,1,1,1,1,0,1,1,1,0,1,0,1,0,1
1,0,1,0,0,0,0,0,1,0,1,0,0,0,0,0,0,0,1,0,0,0,1,0,1,0,1,0,1
1,0,1,0,1,1,1,1,1,0,1,0,1,0,1,1,1,1,1,1,1,0,1,1,1,0,1,0,1
1,0,0,0,1,0,0,0,1,0,1,0,1,0,1,0,0,0,0,0,1,0,0,0,0,0,1,0,1
1,0,0,1,1,1,1,0,1,0,1,1,1,0,1,0,1,0,1,1,1,1,1,0,1,1,1,0,1
1,0,0,0,1,0,1,0,1,0,0,0,1,0,1,0,1,0,0,0,0,0,0,0,1,0,0,0,1
1,1,1,0,1,0,1,0,1,1,1,0,1,0,1,0,1,1,1,1,1,1,1,1,1,0,1,0,1
1,0,1,0,0,0,1,0,0,0,1,0,1,0,0,0,1,0,0,0,0,0,1,0,0,0,1,0,1
1,0,1,1,1,0,1,1,1,0,1,0,1,0,1,1,1,1,1,0,1,0,1,0,1,1,1,1,1
1,0,0,0,1,0,0,0,1,0,1,0,1,0,1,0,0,0,1,0,1,0,1,0,0,0,0,0,1
1,0,1,0,1,1,1,0,1,0,1,0,1,0,1,0,1,0,1,1,1,0,1,1,1,1,1,0,1
1,0,1,0,0,0,1,0,1,0,1,0,1,0,0,0,1,0,1,0,0,0,0,0,0,0,1,0,1
1,0,1,1,1,0,1,0,1,0,1,0,1,1,1,1,1,0,1,0,1,1,1,1,1,1,1,0,1
1,0,1,0,0,0,1,0,1,0,0,0,1,0,0,0,1,0,1,0,1,0,0,0,0,0,0,0,1
1,0,1,1,1,1,1,0,1,1,1,1,1,1,1,0,1,0,1,0,1,0,1,1,1,1,1,0,1
1,0,1,0,0,0,0,0,1,0,0,0,1,0,0,0,1,0,0,0,1,0,0,0,0,0,1,0,1
1,0,1,0,1,1,1,1,1,0,1,0,1,0,1,0,1,1,1,0,1,1,1,1,1,0,1,0,1
1,0,1,0,1,0,0,0,0,0,1,0,0,0,1,0,0,0,1,0,1,0,0,0,1,0,1,0,1
1,0,1,0,1,1,1,1,1,0,1,1,1,1,1,1,1,1,1,0,1,1,1,0,1,0,1,0,1
1,0,1,0,0,0,0,0,1,0,0,0,0,0,0,0,0,0,0,0,0,0,0,0,1,0,1,0,1
1,0,1,1,1,1,1,0,1,0,1,1,1,1,1,0,1,1,1,1,1,1,1,1,1,0,1,0,1
1,0,1,0,0,0,0,0,1,0,1,0,0,0,1,0,1,0,1,0,0,0,0,0,0,0,1,0,1
1,0,1,0,1,1,1,1,1,1,1,0,1,0,1,0,1,0,1,0,1,1,1,1,1,1,1,0,1
1,0,0,0,1,0,0,0,0,0,0,0,1,0,1,0,0,0,1,0,0,0,0,0,1,0,0,0,1
1,0,1,1,1,0,1,1,1,1,1,1,1,0,1,1,1,1,1,1,1,1,1,0,1,0,0,0,1
1,0,0,0,0,0,1,0,0,0,0,0,0,0,0,0,0,0,0,0,0,0,0,0,1,0,0,0,1
1,1,1,1,1,1,1,1,1,1,1,1,1,1,1,1,1,1,1,1,1,1,1,1,1,1,1,1,1